111111111111111111111111111111
10001P100100000000000000010001
10001C000100C00000000000000EC1
100000000000000000000000011111
1000000001C000000C000000000001
10C0000001000C000000000000C001
100000C00000000000C00000000001
111111111111111111111111111111
