1111111111111
1000000000001
1000011111111
100E010111111
1000110110111
1000000000001
1000111000001
1111111101111
1000P000C0001
1111111111111
